{
  "deployment_1": [
    "D-541",
    "D-545",
    "D-546",
    "D-570",
    "D-571",
    "D-575",
    "D-577",
    "D-586",
    "D-588",
    "D-599",
    "D-602",
    "D-603",
    "D-606",
    "D-610",
    "D-611",
    "D-612",
    "D-615",
    "D-625",
    "D-628",
    "D-630"
  ],
  "deployment_2": [
    "D-531",
    "D-543",
    "D-559"
  ],
  "deployment_3": [
    "D-566",
    "D-567",
    "D-582"
  ],
  "deployment_4": [
    "D-433",
    "D-434"
  ],
  "deployment_5": [
    "D-432",
    "D-437",
    "D-439",
    "D-440",
    "D-442",
    "D-443",
    "D-445",
    "D-449",
    "D-460",
    "D-462",
    "D-464",
    "D-465",
    "D-467",
    "D-469",
    "D-473",
    "D-474",
    "D-476",
    "D-483",
    "D-484",
    "D-485",
    "D-486",
    "D-489",
    "D-490",
    "D-494",
    "D-499",
    "D-504",
    "D-507",
    "D-508",
    "D-511",
    "D-513",
    "D-516",
    "D-519",
    "D-521",
    "D-525",
    "D-526",
    "D-528",
    "D-533",
    "D-534",
    "D-540",
    "D-542",
    "D-544",
    "D-550",
    "D-552",
    "D-553",
    "D-554",
    "D-557",
    "D-560",
    "D-562",
    "D-565",
    "D-568",
    "D-572",
    "D-576",
    "D-578",
    "D-581",
    "D-583",
    "D-589",
    "D-591",
    "D-592",
    "D-595",
    "D-597",
    "D-598",
    "D-600",
    "D-601",
    "D-604",
    "D-613",
    "D-614",
    "D-617",
    "D-619",
    "D-623",
    "D-624"
  ]
}
