{
  "deployment_1": [
    "D-541",
    "D-545",
    "D-546",
    "D-570",
    "D-571",
    "D-575",
    "D-577",
    "D-586",
    "D-588",
    "D-599",
    "D-602",
    "D-603",
    "D-606",
    "D-610",
    "D-611",
    "D-612",
    "D-615",
    "D-625",
    "D-628",
    "D-630"
  ],
  "deployment_2": [
    "D-531",
    "D-543",
    "D-559"
  ],
  "deployment_3": [
    "D-566",
    "D-567",
    "D-582"
  ],
  "deployment_4": [
    "D-433",
    "D-434"
  ]
}
